12
12
6, 7, 6, 13, 7, 8, 6, 7, 6, 13, 13, 15,
4, 4, 10, 7, 4, 4, 4, 10, 9, 7, 6, 13,
4, 4, 8, 4, 4, 4, 4, 6, 7, 4, 10, 7,
4, 10, 11, 4, 2, 9, 11, 4, 4, 4, 8, 4,
10, 13, 5, 11, 10, 13, 7, 4, 10, 11, 4, 4,
6, 13, 11, 6, 15, 14, 3, 10, 13, 13, 9, 11,
2, 13, 7, 4, 6, 13, 3, 14, 13, 13, 13, 7,
10, 7, 10, 3, 12, 8, 4, 14, 7, 6, 13, 11,
13, 3, 14, 11, 8, 10, 0, 13, 9, 11, 14, 7,
8, 10, 7, 6, 9, 7, 10, 7, 6, 13, 13, 3,
4, 6, 9, 9, 7, 10, 7, 10, 11, 6, 7, 4,
10, 9, 13, 15, 10, 15, 12, 14, 13, 11, 10, 11
